target	sequence			
FLAG	MAQVQLQQSAAELARPGASVKMSCKASGYSFTTYTIHWVKQRPGQGLEWIGYINPSSGYAAYNQNFKDETTLTADPSSSTAYMELNSLTSEDSAVYYCAREKFYGYDYWGQGATLTVSSGGGGSGGGGSGGGGSDVLMTQIPLSLPVSLGDQASISCRSSQSIVHRNGNTYLEWYLLKPGQSPKLLIYKVSNRFSGVPDRFSGSGSGTDFTLKISRVEAEDLGVYYCFQGSHVPYTFGGGTKLEI			
H3K27ac	EILLQQSGPEVVKPGASVKVSCKASGYSFTEYNMYWVKQSHGKSLEWIGYIGPYNGGSSYTQKFKGKATLTFDKSSSTAFMHLSRLTSEDSAVYYCSDGHYWGQGTTLTVSSSSGGGGSGGGGSGGGGSDVVMTQTPLSLSVTIGQPASISCKSSQSLLYSNGETYLNWLHQRPGQAPKYLMYQVSNKAPGIPDRFSGSGSETDFTLKISRVEAEDLGVYYCLQGTFYPHTFGGGTKLEI			
SarsCoV2nucleocapsid	MAEVKLEESGGGLVQPGGSMKFSCVASGFTFSDYWMNWVRQSPDKGLEWVAEIRLKSNNYATHYAASVKGRFTISRDDSKSSVYLQMNNLRAEDSGIYYCTRSAMDYWGQGTSVTVSSGGGGSGGGGSGGGGSDIVMSQSPSSLAVSVGEKITMSCKSSQSLLYTSDQKNYLAWFQQKPGQSPKLLIFWASTRDSGVPDRFTGSGSGTDFTLTISSVKAEDLAVYYCQQFYNYPRTFGGGTKLEI			
H3S10ph	MAQVTLKESGPGILQPSQTLSLTCSFSGFSLRTSGMGVSWVRQPPGKGLEWLAHIYWDDDKRYTPSLKSRLTISRDTFRNQVFLKITSVDTADSATYYCARRTDDGHYDYALDYWGQGISVTVSSGGGGSGGGGSGGGGSQIVLTQSPAVMSASPGERVTMTCSASSSVTGMHWYQHKSGISPKRWIFDTSKLASGVPARFSGSGSGTSYSLTITSMESEDAATYYCQQWSFNPYTFGGGTKLEIKRA			
H3K4me3	MAEVQLQQSGAELVRPGALVKLSCKASGFNIKDYYLHWVKQRPEQGLEWIGWIDPENGNTFFDPKFQGKASITADTSSNTAYLQLSSLTSEDTAVYFCTRDLYYYGINDYAMDYWGQGTSVTVSSGGGGSGGGGSGGGGSNIVMTQSPKSMSMSVGERVTLSCKASENVGTYVSWYQQKPEQSPKLLIYGASNRYTGVPDRFTGSGSATDFTLTISSVQAEDLADYHCGQSYSYPWTFGGGTKLEIKRA			
H4K16ac	MAQVQLQQSGAELMKPGASVKISCKATGYTFSSYWIEWVKQRPGHGLEWIGEILPGSGSNNYNEKFKGKATFTADTSSNTAYMQLSSLTSEDSAVYYCASTDGYYWGQGTLVTVSAGGGGSGGGGSGGGGSDVVMTQTPLTLSVTIGQPASISCKSSQSLLYSNGKTYLNWLLQRPGQSPKRLIYLVSKLDSGVPDRFTGSGSGTDFTLKISRVEAEDLGVYYCVQGTHFPFTFGSGTKLEIKRA			
H3K36me2	MAEVQLQQSGAELMKPGASVKISCKATGYTFSSYWIEWVKQRPGHGLEWIGEIFPGSGSTNHNEKFKGKATFTADTSSNTAYMQLSSLTSEDSAVYYCASQGNYYGRRPYYFDYWGQGTTLTVSSGGGGSGGGGSGGGGSDIQMTQTTSSLSASLGDRVTISCRASQDISNYLNWYQQKPDGTVKLLIYYTSRLHSGVPSRFSGSGSGTDYSLTISNLEQEDIATYFCQQVNTLPWTFGGGTKLEIKRA			
H3K9me3	MAQIQLVQSGPELKKPGETVKISCKASGYTFTDYSMHWVKQAPGKGLKWMGWINTETGEPTYADDFKGRFAFSLETSASTAYLQINNLKNDDTATYFCARSRFSLYYYGSNYDSYWFFDVWGAGTTVTVSSGGGGSGGGGSGGGGSNIVLTQSPASLAVSLGQRATISCRASESVDTYGNSFMHWYQQKPGQPPKLLIYLASNLESGVPARFSGSGSRTDFTLTIDPVEADDAATYYCQQNNEDPWTFGGGTKLEIKRA			
H3K4me2	MAQVQLQQSGAELMKPGASVKISCKATGYTFSSYWIEWVKQRPGHGLEWIGEILPGSDSTNYNEKFKGKATFTADTSSNTAYMQLSSLTSEDSAVYYCARLITTDYYFDYWGQGTTLTVSSGGGGSGGGGSGGGGSDIVMTQSHKFMSTSVGDRVSITCKASQDVSTAVAWFQQKPGQSPKLLIYWASTRHTGVPDRFTGSGSGTDYTLTISSVQAEDLAVYYCQQHYSIPFTFGSGTKLEIKRA			
H3K14ac	MAQVQLQQSGAELVKSGASVKLSCKASGYTFTNYYMYWVKQRPGQGLEWIGEINPSNGGTNFNEKFKSKATLTVDKSSSTAYMQLSSLTSEDSAVYYCVSYYGSSYWYFDVWGAGTTVTVSSGGGGSGGGGSGGGGSDIVMTQSQKFMSTSVGDRVSVTCKASQNVYTNVAWYQQKPGQSPKALIYSASYRYSGVPDRFTGSGSGTDFTLTISNVQSEDLAEYFCQQYNTYPYTFGGGTKLEIKRA			
H3K36me3	MAQVQLQQSGAELVKPGASVKLSCKTSGYTFTRYYMYWVKQRPGQGLEWIGEINPSNGGTNFNEKFKNKATLTVDKSSSTAYMQLSSLTSEDSAVYYCTQFSYGYDVYFDYWGQGTTLTVSSGGGGSGGGGSGGGGSDIVMTQSQKFMSTSVGDRVSVTCKARQNVGTNVAWYQQRPGQSPKALIYSASYRYSGVPDRFTGSGSGTDFTLTISNVQSEDLAEYFCQQYNSYPLTFGSGTKLEIKRA			
H3S10ph	MAEVQLQQSGAELVRSGASVKLSCTASGFNIIDYYMHWVKQRPDQGLEWIGWIDPENGDAEYAPKFQGKATMTADTSSNTAYLHLSSLTSEDTAVYYCNAYYRYLNAMDCWGQGTSVTVSSGGGGSGGGGSGGGGSDIVMTQSPSSLAMSVGQKVTLSCKSSQSLLNSSNQKNYLAWYQQKPGQSPKLLVYFASTRESGVPDRFIGSGSGTDFTLTISSVQAEDLADYFCQQHYSTPLTFGAGTKLELKRA			
H4K5ac	MAQVQLQQSGAELARPGASVKLSCKASGYTFTSYWMQWVKQRPGQGLEWIGAIYPGDGDTRYTQQFRDKATLSADKSSSTAYMQLNSLTSEDSAVYYCVSIHYSAYFVYWGQGTLVTVSAGGGGSGGGGSGGGGSDVVMTQTPLTLSVTIGQPASISCKSSQSLLDSNGKTYLNWLLQRPGQSPKRLIFLVSKLDSGVPDRFTGSGSGTDFTLKISRVEAEDLGVYYCWQGAHFPWTFGGGTKLEIKRA			
H4K12ac	MAQVQLQQSGPQLVRPGASVKISCKASGYSFTTYWMHWVKQRPGQGLEWIGMIDPSDSETRLNQKFKDKATLTVDKSSSTAYMQLSSPTSEDSAVYYCAKESYGYDDNYWGQGTTLTVSSGGGGSGGGGSGGGGSQIVLTQSPAIMSASPGEKVTMTCSVSSSVSYMYWYQQKPGSSPRLLIYDTSNLASGVPVRFSGSGSGTSYSLTISRMEAEDAATYYCQQWSSYPYTFGGGTKLEIKRA			
H3S28ph	MAQVQLQQSGAELVRPGASVTLSCKASGYTFTDYEIHWVKQTPVHGLEWIGAIDPETGGTAYNQKFKGKATLTADKSSSTAYMELRTLTSEDSAVYYCTSYGGVYWGQGTLVTVSAGGGGSGGGGSGGGGSDVLMTQTPLSLPVSLGDQASISCRSSQSIVHSNGNTYLEWYLQKPGQSPKLLIYKVSNRFSGVPDRFSGSGTGTDFTLKISRVEAEDLGVYYCFQGSHVPYTFGGGTKLEIKRA			
H3T3ph	MAQIQLVQSGPELKKPGETVKISCKASGYTFTNYGMNWVKQAPGKGLKWMGWINTYTGEPTYADDFKGRFAFSLETSASTAYLQINNLKNEDTATYFCAREGVVGRGYAMDYWGQGTSVTVSSGGGGSGGGGSGGGGSDVLMTQTPLSLPVSLGDQASISCRSSQSIVHSNGNTYLEWYLQKPGQSPKLLIYKVSNRFSGVPDRFSGSGSGTDFTLKISRVEAEDLGVYYCFQGSHVPYTFGGGTKLEIKRA			
H3K4me1	MAEVQLQQSGAELVRSGASVKLSCTASGFNIKDYYMNWVKKRPEQGLEWIGWIDPENGDTEYAPKFQGKATMTADTSSNTAYLQLSSLTSEDTAVYYCNDGEYWGQGTPLTVSSGGGGSGGGGSGGGGSDVVMTQTPLTLSVTIGQPASISCKSSQSLLDSDGKTYLNWLLQRPGQSPKRLIYLVSKLDSGVPDRFTGSGSGTDFTLKISRVEAEDLGVYYCWQGTHFPRTFGGGTKLEIKRA			
H3K27me1	MAEVQLQQSGAELVRPGALVKLSCKASGFNIKDYYMYWVKQRPEQGLEWIGWIDPENGNTIYDPKFQGKASITADTSSNTAYLHLSSLTSEDTAVYFCETTGGRYFDVWGAGTTVTVSSGGGGSGGGGSGGGGSDVLMTQTPLSLPVSLGDQASISCRSSQSIVHSNGNTYLEWYLQKPGQSPKLLIYKVSNRFSGVPDRFSGSGSGTDFTLKISRVEAEDLGVYYCFQGSHVPYTFGGGTKLEIKRA			
H3K9un	MAEVQLQQSGAELVRSGASVTLSCTASGFNIKDYYVHWVNQRPEQGLEWIGWIDPENGDTEYAPKFQGKATVTADTSSNTAYLQLSSLTSEDTAVYYCNLYGNFYFDYWGQGTTLTVSSGGGGSGGGGSGGGGSDVVMTQTPLTLSVTIGQPASISCKSSQSLLDSDGKTYLNWLLLRPGQSPTRLIYLVSKLDSGVPDRFTGSGSGTDFTLKISRVEAEDLGVYYCWQGTHFPYTFGGGTTLEIKRA			
H4K20me3	MAEVQLVESGGGLVKPGGSLKLSCAASGFTFSTYAMSWVRQSPEKRLEWVAEISTGGSYTYYPDTVTGRFTISRDNAKNTLYLEMSSLRSEDTAMYYCARDPDYSYALDYWGQGTSVTVSSGGGGSGGGGSGGGGSDVVMTQTPLTLSVTIGQPASISCKSSQSLLYSNGKTYLNWLLQRPGQSPKRLIYLVSKLDSGVPDRFTGSGSGTDFTLKISRVEAEDLGVYYCVQGTHFPYTFGGGTKLEIKRA			
H3K9me1	MAQIQLVQSGPELKKPGETVKISCKASGYTFTNYGMNWVKQAPGKGLKWMGWINTYTGEPTYADDFKGRFAFSLETSASTAYLQINNLKNEDMATYFCAREEIYYDYDYFSYWGQGTLVTVSAGGGGSGGGGSGGGGSDVVMTQTPLSLPVSLGDQASISCRSSQSLVHSNGNTYLHWYLQKPGQSPKLLIYKVSNRFSGVPDRFSGSGSGTDFTLKISRVEAEDLGVYFCSQSTHVPLTFGAGTKLELKRA			
H3K27un	MAQVQLQQSGAELVRPGASVTLSCKASGYTFTDYEMHWVKQTPVHGLEWIGAIDPETGGTAYIQTFKGKATLTADKSSSTAYMELRSLTSEDSAVYYCTREGFITGAMDYWGQGTSVTVSSGGGGSGGGGSGGGGSDVVMTQTPLSLSVTIGQPASISCKSSQSLLYSNGKTYLNWLQQRPGQAPKHLMYQVSKLDPGIPDRFSGSGSETDFTLKISRVEAEDLGVYYCLQGTSYPWTFGGGTKLEIKRA			
H3K27me1	MAEVQLQQSGAELVRPGALVKLSCKASGFNIKDYYMYWGKQRPEQGLEWIGWIDPENGNTIYDPKFQGKASITADTSSNTAYLHLSSLTSEDTAVYFCETTGGRYFDVWGAGTTVTVSSGGGGSGGGGSGGGGSDVLMTQTPLSLPVSLGDQASISCRSSQSIVHSNGNTYLEWYLQKPGQSPKLLIYKVSNRFSGVPDRFSGSGSGTDFTLKISRVEAEDLGVYYCFQGSHVPYTFGGGTKLEIKRA			
H3K27me2	MAEVQLQQSGAEFVRSGASVKLSCTASGFKIKDYYMHWVKQRPEQGLEWIGWIDPENGDIEYGPKFQGKATMTADTSSNTAYLQLSSLTSEDTAVYYCNAYDYGAMDYWGQGTSVTVSSGGGGSGGGGSGGGGSEIVLTQSPTTMAASPGEKITITCSASSSISSNYLHWYQQKPGFPPKLLIYKTSNLASGVPARFSGSGSGTSYSLTIGTMEAEDVATYYCQQGNSIYTFGGGTKLQIKRA			
H3K9me2	MAQVQLQQSGAELARPGTSVKLSCKASGYTFTSYWMQWVKQRPGQGLEWIGAIYPGDGDTRYTQKFKGKATLTADKSSSTAYMQLSRLASEDSAVYYCASYDHSYGLDYWGQGTSVTVSSGGGGSGGGGSGGGGSQIVLTQSPALMSASPGEKVTMTCSASSSVSYMYWYQQKPRSSPKPWIYLTSNLASGVPARFSGSGSGTSYSLTISSMEAEDAATYYCQQWSSNPLTFGAGTKLELKRA	
H4K8ac	MAQVQLQQSGPELVKPGASVRISCKASGYTFTSYYVQWVKQRPGQGLEWIGWIYPGNVKTEYNEKFKGKATLTADKSSSTAYMQLSSLTSEDSAVYFCARGDDGYYVDYAMDYWGQGTSVTVSSGGGGSGGGGSGGGGSDIVMTQSQKFMSTSVGDRVSVTCKASQNVGTNVAWYQQKPGQSPKALIYSASYRYSGVPDRFTGSGSGTDFTLTISNVQSEDLAEYFCQQYNSYPFTFGGGTKLEIKRA
